XXXXXXXXXXXXXXXXXXXXXXXXXXXXXXXXXXXXXXXXXXXXXXXXX
E                                               X
XXXXXXXX XXXXXXXXXXXXXXXXXXX X XXXXXXXXXXXXXXXXXX
XXXXXXXXXXXXX                X XXXXXXXXXXXXXXXXXX
X          XXXXXXXXXXXXXXXXXXX X                X
XXXXXXXXXX                     XXXXXXXXXXXXXXXX X
X        XXX XX XXXXXXXXXXXXXX XXXXXXXXXXXXXXXX X
X XXXXXXXXXX XX X   XXXXXXXXXX                  X
X X      X X XX X X X  XX XXXXXXXXXXXXXXXXXXXXXXX
X XXXXXX X X XX   X       X    XX     XXX     XXX
X            XX XXXXXXXXXXX XX XX XXX XXX XXX X X
XXXXXXXXXXXX XX             XX    XXX     X X X X
X          X XXXXXXXXXXXXXXXXXXXXXXXXXXXXXX X X X
X XXXXXXXX X                             XX X X X
X X      X X XXXXXXXXXXXXXXXXXXXXXXXX XX XX     X
X X      X X X        XXXXXX XXX XXXX XX XX     X
X XXXXXX X XXX XXXXXXXXX            X XX XXXXXXXX
X      X          X    X XXXXXXXXXX X XX X      X
XXXXXX XXXXXXXXXXXX XX X X X X XXXX X XX X X XX X
X                   XX   X          X XX X X XX X
X XXXXXXXXXXXXXXXXX XXXXXXXXXXXXXXXXX XX X X X  X
X                                   X XX X X XX X
XXXXXXXXXXXXXXXXXXXXXXXXXXXXXXXXXXX X XX XXX XXXX
X                                   X XX X     XX
X XXXXXXXXXXXXXXXXXXXXXXXXXXXXXXXXXXX XX XX XX  X
X                                     XX    XXX X
XXXXXXXXXXXXXXXXXXXXXXXXXXXXXXXXXXXXXXXXXXXXXXXXX